XXXXXXXXXXXXXXXXXXXXXXX
X                     X
X                     X
X                 e   X
X                     X
X                     X
X                     X
X                     X
X      f              X
X                     X
X                     X
X            A        X
X                     X
X                     X
X                     X
X                     X
X                     X
X                     X
X                     X
X                     X
X                     X
X         a           X
XXXXXXXXXXXXXXXXXXXXXXX