XXXXXXXXXXXXXXXXXXXXXXX
X                     X
X                     X
X                     X
X                     X
X                     X
X                     X
X                     X
X                     X
X         b           X
X                     X
X            A        X
X                     X
X                     X
X                     X
X                 a   X
X                     X
X                     X
X                     X
X                     X
X                     X
X                     X
XXXXXXXXXXXXXXXXXXXXXXX